Player,Rating,Deviation,Games,Win,Draw,Loss,Lag
Naomi Osaka,1967.4138799889745,72.85316927779292,234,155,0,79,2
Ashleigh Barty,1964.157883025336,73.18234599750755,240,171,0,69,1
Bianca Andreescu,1914.5863581883457,78.8168017148909,77,59,0,18,2
Serena Williams,1901.686567931518,71.47726799825429,701,598,0,103,7
Garbine Muguruza,1890.9141363596611,67.11153727521167,436,283,0,153,1
Aryna Sabalenka,1889.5268480915167,67.32852345703579,207,140,0,67,2
Simona Halep,1884.8042548155986,74.98255908422007,592,413,0,179,2
Elise Mertens,1853.8068893821496,68.29619367629665,255,166,0,89,1
Victoria Azarenka,1846.5776399859678,69.42982507432505,583,420,0,163,2
Elina Svitolina,1832.439371561789,69.14083051920635,469,306,0,163,0
Maria Sakkari,1817.1297447237737,67.95698170065614,218,114,0,104,2
Petra Kvitova,1813.0132879796124,70.35558966363872,654,449,0,205,1
Anett Kontaveit,1810.3739132861206,68.51206473177182,263,153,0,110,2
Iga Swiatek,1809.012483195614,71.32397869521597,65,43,0,22,2
Jessica Pegula,1805.7513730885125,67.84927653537132,91,50,0,41,2
Darya Kasatkina,1799.7980882020051,66.0385592369113,258,149,0,109,3
Karolina Muchova,1789.7717111526238,69.64905090707082,70,44,0,26,7
Ons Jabeur,1783.7195573801152,67.25202031780346,179,97,0,82,0
Jennifer Brady,1783.2518301610949,69.04311544623455,125,62,0,63,2
Barbora Krejcikova,1771.0660147950975,72.90705319169287,56,31,0,25,2
Danielle Rose Collins,1764.958483837927,71.3392733871291,106,57,0,49,2
Sofia Kenin,1761.1815418515828,72.11851142213527,160,101,0,59,1
Karolina Pliskova,1756.578124310951,70.64051473156273,501,330,0,171,2
Shelby Rogers,1754.9334859674086,71.4228159595859,166,79,0,87,0
Veronika Kudermetova,1753.7728309983052,67.37118118575859,111,63,0,48,1
Cori Gauff,1753.021616512088,69.90023223966918,53,33,0,20,1
Kaia Kanepi,1731.523086296055,75.52120564466163,363,205,0,158,2
Marketa Vondrousova,1728.5322112230103,70.54156828337685,118,70,0,48,2
Tsvetana Pironkova,1727.6725985241535,87.28783424609306,356,157,0,199,1
Jelena Ostapenko,1727.621673599038,70.36813898376722,269,149,0,120,0
Ekaterina Alexandrova,1727.46728221267,68.28347247536236,155,83,0,72,2
Sara Sorribes Tormo,1726.9196587382849,66.621566692896,156,72,0,84,1
Yulia Putintseva,1719.2812738871355,70.15710900909463,310,153,0,157,0
Elena Rybakina,1717.3865057279957,69.99612090450704,94,62,0,32,0
Kiki Bertens,1714.4916540497652,77.80690162711063,405,236,0,169,0
Leylah Annie Fernandez,1709.1311936671004,74.54742205651043,40,23,0,17,0
Amanda Anisimova,1707.7038060204811,74.2903113111886,82,48,0,34,1
Dayana Yastremska,1705.2126481191715,70.27195366740732,105,61,0,44,11
Paula Badosa,1704.8176126727437,71.56460715913386,57,28,0,29,1
Carla Suarez Navarro,1703.4813142621585,74.91740182736267,594,348,0,246,22
Danka Kovinic,1699.641205832201,73.84568935326197,163,73,0,90,0
Svetlana Kuznetsova,1697.4510284767157,71.56276516890799,645,405,0,240,2
Julia Goerges,1696.7674634760756,74.27562172309787,557,308,0,249,13
Belinda Bencic,1696.5656263752621,71.03214638111464,290,165,0,125,1
Su Wei Hsieh,1694.5762834278567,73.80742854349243,313,157,0,156,7
Jil Belen Teichmann,1691.254215099545,68.25576956089326,84,43,0,41,2
Marie Bouzkova,1689.8273966110432,71.58063894172354,64,31,0,33,1
Madison Keys,1688.8053550629963,77.23767755211227,345,213,0,132,1
Anastasia Pavlyuchenkova,1687.5402408079062,70.63631848865805,615,351,0,264,3
Fiona Ferro,1687.3841298974628,73.38524316354456,77,37,0,40,2
Johanna Konta,1684.4998219425634,74.53052261370775,306,184,0,122,2
Laura Siegemund,1679.0797351401463,71.55419318652287,176,87,0,89,2
Catherine Cartan Bellis,1678.8407857262448,84.00209907930352,78,41,0,37,13
Anastasija Sevastova,1674.6134026494742,70.29147867839478,363,204,0,159,0
Ana Konjuh,1671.29465186887,99.85367278450228,131,73,0,58,2
Viktorija Golubic,1670.7831884011275,75.68867194059581,119,55,0,64,3
Angelique Kerber,1666.2721738501489,73.98733083353513,660,422,0,238,2
Caroline Garcia,1666.1077681977033,70.07728687828838,421,234,0,187,2
Alize Cornet,1665.1061424772308,71.41349225364408,574,288,0,286,0
Alison Riske,1658.9929866177174,76.20034409849495,313,152,0,161,7
Donna Vekic,1658.8989505703257,70.40438576301912,294,147,0,147,7
Eugenie Bouchard,1657.5982556816598,74.68882812420591,303,161,0,142,3
Margarita Gasparyan,1657.0364469504404,74.44540615615647,105,50,0,55,3
Irina Camelia Begu,1654.0610741541623,74.9284911593126,372,186,0,186,2
Anastasia Potapova,1648.9759231463906,74.49386138390153,68,35,0,33,1
Andrea Petkovic,1648.4466203596364,79.77536456840458,479,270,0,209,2
Vera Zvonareva,1648.0018698505544,76.56868223403274,367,234,0,133,3
Zarina Diyas,1645.2244091589564,73.53911338047172,223,105,0,118,1
Aliaksandra Sasnovich,1643.1893834681318,70.20420719929614,205,101,0,104,3
Katie Boulter,1642.1915543569203,86.26149867434303,39,19,0,20,0
Petra Martic,1640.344725669014,71.4501855470141,292,148,0,144,2
Sorana Cirstea,1640.2909439177804,73.51704918978541,450,217,0,233,2
Camila Giorgi,1638.9623526190255,72.96505814811314,305,159,0,146,2
Kim Clijsters,1637.1925768652777,142.2317881608117,275,217,0,58,17
Kristina Mladenovic,1636.774278693044,70.3861922671238,421,206,0,215,1
Shuai Zhang,1636.1026499605491,75.13437898715087,346,159,0,187,1
Anna Karolina Schmiedlova,1635.9823810220312,74.56710343085143,198,88,0,110,1
Saisai Zheng,1627.90983188263,73.38876180083328,210,89,0,121,1
Patricia Maria Tig,1626.4949467014546,75.70918161489386,75,37,0,38,5
Venus Williams,1625.1587896680435,78.25003855589523,623,455,0,168,2
Alison Van Uytvanck,1623.9680987080621,72.2297873993072,231,107,0,124,7
Daria Gavrilova,1622.1236288732155,85.69310487498309,245,125,0,120,7
Astra Sharma,1620.594596228706,80.21502401885509,37,17,0,20,0
Taylor Townsend,1619.933424122286,89.05585750335473,72,29,0,43,17
Qiang Wang,1619.0444375400527,73.37041327958153,236,127,0,109,2
Magda Linette,1618.6522052312298,75.15868052143017,216,102,0,114,0
Ajla Tomljanovic,1610.226942714023,71.55597881090767,253,113,0,140,0
Oceane Dodin,1608.9596502646589,84.89096346404682,78,32,0,46,2
Marta Kostyuk,1608.542036014811,85.23344516236013,34,16,0,18,0
Nadia Podoroska,1608.2556119672363,76.68948689783552,49,27,0,22,0
Kaja Juvan,1607.799379769697,79.65258521799197,39,18,0,21,3
Tamara Zidansek,1604.6097145709962,70.6680011626176,92,46,0,46,1
Polona Hercog,1604.2956315359954,73.92286853786402,377,174,0,203,5
Barbora Zahlavova Strycova,1603.5599845804654,75.84160703214596,536,273,0,263,7
Monica Puig,1603.4715860659217,81.38632582994255,299,155,0,144,13
Ludmilla Samsonova,1599.4728853012061,81.31681030678892,32,12,0,20,0
Anna Lena Friedsam,1597.013455040617,85.96674880031244,109,51,0,58,1
Rebecca Peterson,1596.1354953329183,74.78486332775084,126,58,0,68,2
Sara Errani,1587.9245933184886,79.45458933493688,593,340,0,253,0
Katerina Siniakova,1587.8890972024465,72.34787342551579,252,113,0,139,2
Xiyu Wang,1587.6857781677343,86.26894708899948,31,13,0,18,0
Lauren Davis,1584.0352781566464,72.48573059772599,250,113,0,137,0
Lesia Tsurenko,1582.682155542618,83.88975397595982,302,140,0,162,3
Bernarda Pera,1582.0798300104614,73.45515433069278,84,37,0,47,1
Kirsten Flipkens,1581.8501200457424,77.40023590986188,424,202,0,222,2
Sloane Stephens,1581.8071201133632,72.72095177998726,397,231,0,166,1
Shuai Peng,1578.3914599500235,79.90605395986103,438,237,0,201,24
Samantha Stosur,1575.0522094800547,81.08359733870384,680,401,0,279,6
Nao Hibino,1574.759231720226,74.38741492734259,143,67,0,76,0
Ana Bogdan,1573.5507516791445,78.47345207464726,104,42,0,62,3
Tatjana Maria,1570.6447132802653,76.37907092332594,226,82,0,144,17
Tereza Martincova,1564.9650291044459,77.77200957071604,71,26,0,45,0
Anna Kalinskaya,1564.4468115339864,80.6993897603647,49,15,0,34,1
Jasmine Paolini,1563.8450847287631,76.44142618634058,53,19,0,34,0
Greetje Minnen,1561.2047201659022,77.29769882440455,35,15,0,20,4
Heather Watson,1561.0314428567451,75.83664883496556,304,138,0,166,0
Misaki Doi,1559.160755238835,76.53390684723591,246,99,0,147,0
Bethanie Mattek Sands,1558.7849574262455,104.76391597440293,242,101,0,141,8
Arantxa Rus,1557.9704905945632,74.1807387041968,171,64,0,107,0
Kristyna Pliskova,1556.5632150289412,75.11621354536959,214,87,0,127,2
Lara Arruabarrena,1556.250288224802,91.39135382669504,220,100,0,120,1
Rebecca Marino,1552.8631064426831,113.29518051967081,60,25,0,35,0
Christina Mchale,1551.9673085189468,75.98934513171574,378,173,0,205,0
Lucie Hradecka,1551.4409168788416,124.96935329584156,205,88,0,117,10
Nina Stojanovic,1551.3592556925032,77.26571712810582,51,19,0,32,0
Lin Zhu,1550.755770081449,79.97402127853405,94,38,0,56,3
Anna Blinkova,1549.4408012759213,73.6221093871219,84,30,0,54,2
Madison Brengle,1546.092770058549,79.60168259204862,186,72,0,114,0
Yanina Wickmayer,1543.299360146985,100.4632323812827,424,224,0,200,17
Mona Barthel,1542.4979122144084,86.82830397851838,322,152,0,170,7
Su Jeong Jang,1542.261747609144,106.81368590678476,36,15,0,21,21
Viktoria Kuzmova,1536.8986698938133,75.50074535034865,101,46,0,55,3
Kurumi Nara,1534.1255731266147,95.08047645596697,216,92,0,124,1
Kristie Ahn,1532.87691546681,90.28729800759311,43,15,0,28,0
Magdalena Frech,1529.9734947127286,99.02488301080334,38,12,0,26,0
Monica Niculescu,1527.4743798523966,86.83869713330564,397,186,0,211,7
Antonia Lottner,1526.1864019770508,94.49293849214368,39,12,0,27,21
Pauline Parmentier,1523.2671668898056,80.54682171871147,287,106,0,181,13
Kateryna Kozlova,1522.6542741702633,80.1742266149072,133,55,0,78,13
Kristina Kucova,1520.7019218795929,99.95039677476579,81,29,0,52,2
Mandy Minella,1517.1838705983807,88.5042393464636,179,73,0,106,21
Sachia Vickery,1516.154196774291,100.01410833401941,77,32,0,45,1
Olga Govortsova,1515.8265726210861,103.57864298497377,270,110,0,160,17
Ysaline Bonaventure,1515.223962595594,83.74920105046593,56,22,0,34,7
Kateryna Bondarenko,1514.8094901985796,83.53981614097468,257,112,0,145,10
Viktoriya Tomova,1512.9979332972184,88.32182896294543,43,15,0,28,0
Vera Lapko,1512.4846384373634,89.3140462601312,50,21,0,29,3
Stefanie Voegele,1510.5316538157917,80.95617356348339,275,104,0,171,0
Yafan Wang,1507.8106552273825,77.12654735870858,119,55,0,64,0
Natalia Vikhlyantseva,1506.9980639084338,92.0696886319799,90,36,0,54,0
Renata Zarazua,1506.4467971894635,88.11377381489027,37,14,0,23,0
